10,10
texture:
0,0,0,0,0,0,0,0,0,0
0,1,1,0,0,0,0,0,0,0
0,0,1,1,1,1,1,0,0,0
0,0,0,1,1,0,1,0,0,0
0,0,0,0,0,1,1,0,0,0
0,0,1,1,1,0,0,0,0,0
0,1,1,0,0,1,1,1,0,0
0,1,0,1,1,1,0,1,0,0
0,0,1,1,0,0,0,0,0,0
0,0,0,0,0,0,0,0,0,0
collision:
0,0,0,0,0,0,0,0,0,0
0,1,1,0,0,0,0,0,0,0
0,0,1,1,1,1,1,0,0,0
0,0,0,1,1,0,1,0,0,0
0,0,0,0,0,1,1,0,0,0
0,0,1,1,1,0,0,0,0,0
0,1,1,0,0,1,1,1,0,0
0,1,0,1,1,1,0,1,0,0
0,0,1,1,0,0,0,0,0,0
0,0,0,0,0,0,0,0,0,0
